%%%%%%%%%%%%%%%%%%%%
%G                 %
%%%%%%%%           %
%         %        %
%         %        %
%     %%%%%        %
%     %            %
% %%%%%%%%%%%%%%%%%%
%                  %
%                  %
%                  %
%                  %
%  %%%%%%%%%%%%%%%%%
%                  %
%%%%%%%%%%%%%%%    %
%                  %
%  %%%%%%%%%%%%%%%%%
%                  %
%                 P%
%%%%%%%%%%%%%%%%%%%%